caro	expensive
listo	ready
listo	clever
cansado	tired
occupado	busy
casado	married
pronto	quick
tarde	late
politico	political
logico	logical
necesario	necessary
infirmo	sick
bien	good
vestido	dressed
aburrido	boring
alto	tall
moreno	dark
delgado	thin
borracho	drunk
genial	great
abierto	open
alegre	happy
bajo	short
barato	cheap
bonito	pretty
cerrado	closed
claro	clear
gordo	fat
nuevo	new
muerto	dead
malo	bad
maduro	ripe
vivo	alive
sabroso	tasty
