abuelo	grandfather
abuela	grandmother
cuñado	brother-in-law
cuñada	sister-in-law
esposo	husband
esposa	wife
hermano	brother
hermana	sister
hijo	son
hija	daughter
madre	mother
nieto	grandson
nieta	granddaughter
nuera	daughter-in-law
padre	father
primo,prima	cousin
sobrino	nephew
sobrina	niece
suegro	father-in-law
suegra	mother-in-law
tío	uncle
tía	aunt
yerno	son-in-law
